xx#-----F#
  #BB---#
  #D D###
  #D CB-#
  #-----#
  #12--#