###########
--IDDFDDI--
-BB#####BB-
1--#   #--2
####   ####